S . . # . .
. # . # . .
. # . . . .
. . # # . T
. . . . . .
