S . . . . # . . . . . . . . .
. # # # . # . # # # . # # . .
. . . # . . . . . . . . # . .
# # . # # # # # . # # . # . .
. . . . . . . # . . . . . . .
. # # # # . . # # # # # # # .
. . . . . . . . . . . . . . .
. # # # # # # # . # # # # . #
. . . . . . . . . . . . . . .
# # # # . # # # # # # . # # #
. . . . . . . . . . . . . . .
. # # # # # . # # # # # # . .
. . . . . . . . . . . . . . .
. # # # # # # # # # # # # . .
. . . . . . . . . . . . . T
